+---------------------------------------------------------------------------+
|                                                                           |
|  XXXX   XX   X     X  X  X  XX XXXX X   X   XX X XXX  XXX    XXX   XXXXXX |
|   X XXXXXX  XX  XX XX X  X X   X X X  XX     XX   XX    X      X XXXX  XX |
|       XXXXXXX   X XX X X         X   XX  X X      XXX XXX   XXXX       X  |
|  XX    X   XXXX X  X XXX X XXXX     S   X X XXX   X      XXX X        XX  |
|  XX XX   XX   X XX X X XX  X X   X      X X  X      X XX XX  X X      X   |
|   X XX       XX         XX             X XXX  XXX  X   X  XXX    X X      |
|   X X   X X  X  X     XX XX X XXX X    X  XX X    XX  X  XX  X      X  X  |
|   XXX      X  X X  X  X XXXX      X X X   X  X  X       X   X             |
|   X XX      XX  X     X X X      XX XXX XXXX        X X X   X     XX  X X |
|     XX X  X    XXX    XXXX          XXXXXX X X XXX X XX    X     XXX   XX |
|     X X       X X     XXXX XX  X XXXXXX XXXX XX  XXX          X X     XX  |
|  X  X         X   X XXXXX    X   XX XX   X   XX XXX       X     X X X XXX |
|   X XXXXXX  XX  XX XX X  X X   X X X  XX     XX   XX    X     XX XXXX  XX |
|       XXXXXXX   X    X X         X   XX  X X       X  XXX    XXX      XX  |
|  XX    X   XXXX X  X XXX X XX X             XXX   X      XXX X        XX  |
|  XX XX   XX   X XX X X XX  X X   X      X X  X      X XX XX  X X      X   |
|   X XX       XX         XX             X XXX  XXX  X   X   XX             |
|   X X   X X  X  X     XX XX X XXX X    X  XX X    XX  X  XX  X      X  X  |
|   XXX      X  X X  X  X XXXX      X X X   X  X  X       X   X             |
|   X XX      XX  X     X X X      XX XXX XXXX        X X X   X     XX  X X |
|     XX X  X    XXX    XXXX          XXXXXX X X XXX X XX    X     XXX   X  |
|     X X       X X     XXXX XX  X XXXXXX XXX  XX  XXX          X X     XX  |
|  X  X         X   X XXXXX    X   XX XX   X   XX XXX       X     X X   XX  |
|     X     X  X  X     XXXX     XX   X   XX    XXXX          XX     X X X  |
|  X XXX     X   X XX X      X         X     X   X X  X     XXX       XXX   |
|    XX   XX XXXX  X   XX X    XX           X     XX            X X   X   X |
|  X      X  X  X              X    X    X X     X X X    XX   XX X  XXX  X |
|  X  XX  X       X X  X X         XX X   X   X X   X X           X  X    X |
|  X  X    X X    X         XXX    X XX      XXXXX X X X    X       XX      |
|  X        XX    X   X           X           XX        X  X    X     X     |
|  X X   X XXX   X X  X           X  X X XX    X       XX     X X  X X      |
|  X X X    XX  X   XX        XX     X        X X    XXXX    XXXX    X      |
|  X XX     X       X X X XX    X             XX   X  X        X            |
|  X    X  X X   X        X   XX   X  X X            X  XXX         X X     |
|  X X   X  XX    X   X    X   X  XX  X XX   XXX      X        XX   XX X    |
|  X         X     X XX  XX          XX X XXX  X     XX X           X XX    |
|     X  X   X X  X X  X  XX  X      XX            XXX  XX            XXX   |
|  X  X  X X XXX       X X     XX  XX    X     X XXX     X    XX     XXX  X |
|  X         XX   XX        XXXX  X     X                  X   X      XX XX |
|  X X     X X     XX X    XXX X        X      X               X X    XXX   |
|  X X     X  X    X   X      X   X    XXX   X     X       X      X  XXX    |
|  X X     XX        X X X    X X            X                       XXX    |
|  X X       X   X     X                X        X   XXX          XX   X    |
|  X      X  XX X         X  X X           X X  X        X            XX    |
|  XX      XXXX       X            X  X      X  X   X               X X     |
|   X XX     XX X     XX  X    XX            X  X X      XX    X  X   XXX   |
|    X  X   XX X      X   X   X X      X XX  X  X         X             X   |
|   XXXX XXXX    X X       XX XXX      X        X X X   X      X            |
|  X      XX           X       XX XX X  X  X  X    X          X   X     XX  |
|          X X   X                                                          |
|     X     X  X  X     XXXX     XX   X   XX    XXXX          XX X   X X X  |
|  X XXX     X   X XX X      X         X     X   X X  X     XXX    X  XXX   |
|    XX   XX XXXX  X   XX X    XX           X     XX            X X   X   X |
|  X      X  X  X              X    X    X X     X X X    XX   XX X  XXX  X |
|  X  XX  X       X X  X X         XX X   X   X X   X             X  X    X |
|  X  X    X X    X         XXX    X XX      XXXXX X X X    X   X   XX      |
|  X        XX    X   X           X           XX        X  X    X     X  X  |
|  X X   X XXX   X X  X           X  X X XX    X       XX     X X  X X      |
|  X X X    XX  X   XX        XX     X        X X    XXXX    XXXX    X      |
|  X XX     X       X X X XX    X             XXX  X  X        X            |
|  X    X  X X   X        X   XX   X  X X            X  XXX         X X     |
|  X X   X  XX    X   X    X   X  XX  X XX   XXX      X        XX   XX X    |
|  X         X     X XX  XX          XX X XXX  X     X  X           X XX    |
|     X  X   X X  X X  X  XX  X      XX            XXX  XX            XXX   |
|  X  X  X X XXX       X X      X  XX    X     X XXX     X     X     XXX  X |
|  X         XX   XX        XXXX  X     X           X      X X X      XX XX |
|  X X     X X     XX X    XXX X    X   X      X               X X    XXX   |
|  X X     X  X    X   X      X   X    XXX   X     X       X      X  XXX    |
|  X X     XX        X X X    X X            X                       XXX    |
|  X X       X   X     X                X        X   XXX          XX   X    |
|  X      X  XX X         X  X X           X X  X        X            XX  X |
|  XX      XXXX       X            X  X      X  X   X               X X     |
|   X XX     XX X     XX  X    XX               X        XX    X  X   XXX   |
|    X  X   XX X      X   X   X X      X XX  X  X         X             X   |
|   XXXX XXXX    X X       XX XXX      X        X X X   X      X            |
|  X      XX           X       XX XX X  X  X  X               X   X     XX  |
|  XXXX   XX         X  X  X  XX XXXX X   X   XX X XXX  XXX   XXXX   XXXXXX |
|   X XXXXXX  XX  XX XX X  X X   X X X  XX     XX   XX    X      X XXXX  XX |
|       XXXXXXX   X    X X         X   XX  X X       X  XXX    XXX       X  |
|  XX    X   XXXX X  X XXX X XX X             XXX   X      XXX X        XX  |
|  XX XX   XX   X XX X X XX  X X   X      X X  X      X XX XX  X X      X   |
|   X XX       XX         XX             X XXX  XXX  X   X   XX             |
|   X X   X X  X  X     XX XX X XXX X    X  XX X    XX  X  XX  X      X  X  |
|   XXX      X  X X  X  X XXXX  X   X X X   X  X  X       X   X           X |
|   X XX      XX  X     X X X      XX XXX XXXX        X X X   X     XX  X X |
|     XX X  X    XXX    XXXX          XXXXXX X X XXX X XX    X     XXX   X  |
|     X X       X X     XXXX XX  X XXXXXX XXX  XX  XXX          X X     XX  |
|  X  X         X   X XXXXX    X   XX XX   X   XX XXX       X     X X   XX  |
|     X     X  X  X     XXXX     XX   X   XX    XXXX          XX     X X X  |
|  X XXX     X   X XX X      X         X     X   X X  X     XXX       XXX   |
|    XX   XX XXXX  X   XX X    XX           X     XX            X X   X X X |
|  X      X  X  X              X    X    X X     X X X    XX   XX X  XXX  X |
|  X  XX  X       X X  X X         XX X   X   X X   X             X  X    X |
|  X  X    X X    X         XXX    X XX      XXXXX X X X    X       XX      |
|  X        XX    X   X           X           XX        X  X    X     X     |
|  X X   X XXX   X X  X           X  X X XX    X       XX     X X  X X      |
|  X X X    XX  X   XX        XX     X        X X    XXXX    XXXX    X      |
|  X XX     X       X X X XX    X             XX   X  X        X            |
|  X    X  X X   X        X   XX   X  X X            X  XXX         X X     |
|  X X   X  XX    X   X    XX  X  XX  X XX   XXX      X        XX   XX X    |
|  X         X     X XX  XX          XX X XXX  X     X  X           X XX    |
|     X  X   X X  X X  X  XX  X      XX            XXX  XX            XXX   |
|  X  X  X X XXX       X X      X  XX    X     X XXX     X     X     XXX  X |
|  X         XX   XX        XXXX  X     X                  X   X      XX XX |
|  X X     X X     XX X    XXX X        X      X               X X    XXX   |
|  X X     X  X    X   X      X   X    XXX   X     X       X      X  XXX    |
|  X X     XX        X X X    X X            X                       XXX    |
|  X X       X   X     X                X        X   XXX          XX   X    |
|  X      X  XX X         X  X X           X X  X        X            XX    |
|  XX      XXXX       X            X  X      X  X   X               X X     |
|   X XX     XX X     XX  X    XX               X        XX    X  X   XXX   |
|    X  X   XX X      X   X   X X      X XX  X  X         X             X   |
|   XXXX XXXX   XXXX       XX XXX X    X        X X X   X   X  X            |
|XXX      XX        X  X  X X  XX XX X  X  X  X               X   X     XX  |
|          X X   X                                 X                        |
|                 X X X   X                XX                  X         X  |
|  XXXX   XX         X  X  X  XX XXXX X   X X XX X XXX  XXX    XXX   XXXXXX |
|   X XXXXXX  XX  XX XX X XX X   X X X  XX     XX   XX    X      X XXXX  XX |
|       XXXXXXX   X X  X X         X   XX  X X      XX  XXX    XXX   X   X  |
|  XX    X   XXXX X  X XXX X XX X           X XXX   X      XXX X       XXX  |
|  XX XX   XX   X XX X X XX  X X   X      X X  X      X XX XX  X X      X   |
|   X XX       XX         XX             X XXX  XXXX X   X   XX     X       |
|   X X   X X  X  X     XX XX X XXX X    X  XX X    XX  X  XX  X      X XX  |
|   XXX      X  X X  X  X XXXX      X X X   X  X  X       X   X             |
|   X XX      XX  X     X X X      XX XXX XXXX        X X X   X     XX  X X |
|     XX X  X    XXX    XXXX          XXXXXX X X XXX X XX    X     XXX   X  |
|     X X       X X     XXXX XX  X XXXXXX XXX  XX  XXX          X X     XX  |
|  X  X         X   X XXXXX    X   XX XX   X   XX XXX       X     X X   XX  |
|     X     X  X  X     XXXX     XX   X   XX    XXXX          XX     X X X  |
|  X XXX     X   X XX X      X         X     X   X X  X     XXX       XXX   |
|    XX   XX XXXX  X   XX X    XX           X     XX            X X   X   X |
|  X      X  X  X              X    X    X X     X X X    XX   XX X  XXX  X |
|  X  XX  X       X X  X X         XX X   X   X X   X             X  X    X |
|  X  X    X X    X         XXX    X XX      XXXXX X X X    X       XX      |
|  X        XX    X   X           X           XX        X  X    X     X     |
|  X X   X XXX   X X  X           X  X X XX    X       XX   X X X  X X      |
|  X X X    XX  X   XX        XX     X        X X    XXXX    XXXX    X      |
|  X XX     X       X X X XX    X             XX   X  X        X X          |
|  X    X  X X   X        X   XX   X  X X            X  XXX         X X     |
|  X X   X  XX    X   X    X   X  XX  X XX   XXX      X        XX   XX X    |
|  X         X     X XX  XX          XX X XXX  X     X  X           X XX    |
|     X  X   X X  X X  X  XX  X      XX           XXXX  XX            XXX   |
|  X  X  X X XXX       X X      X  XX    X     X XXX     X     X     XXX XX |
|  X         XX   XX        XXXX  X     X                  X   X      XX XX |
|  X X     X X     XX X    XXX X        X      X               X X    XXX   |
|  X X     X  X    X   X      X   X    XXX   X     X       X      X  XXX    |
|  X X     XX        X X X    X X            X                       XXX    |
|  X X       X   X     X                X        X   XXX         XXX  XX    |
|  X      X  XX X         X  X X           X X  X        X            XX    |
|  XX      XXXX       X            X  X      X  X   X    X          X X     |
|   X XX     XX X     XX  X    XX               X        XX    X  X   XXX   |
|    X  X   XX X      X   X   X X      X XX  X  X         X             X   |
|   XXXX XXXX    X X       XX XXX      X        X XXX   X      X            |
|  X      XX           X      XXX XX X  X  X  X X           X X   X     XXX |
|          X XXX X XX X X       XX      XX   X    X X                       |
|                    X                                                      |
|  XXXX   XX         X  X  X  XX XXXXXX X X   XX X XXX  XXX    XXX   XXXXXX |
|   X XXXXXX  XX  XX XX X  X X   X X X  XX     XX   XX    X      X XXXX  XX |
|       XXXXXXX   X    X X         X   XX  X X       X  XXX    XXX  X    X  |
|  XX    X   XXXX X  X XXX X XX X             XXX   X      XXX X        XX  |
|  XX XX   XX   X XX X X XX  X X   X      X X  X X    X XX XX  X X      X   |
|   X XX       XX         XX             X XXX  XXX  X   X   XX             |
|   X X   X X  X  X     XX XX X XXX X    X  XX X    XX  X  XX  X      X  X  |
|   XXX      X  X X  X  X XXXX      X X X   X  X  X       X   X             |
|   X XX      XX  X     X X X      XX XXX XXXX        X X X   X     XX  XXX |
|     XX X  X    XXX    XXXX          XXXXXX X X XXX X XX    X     XXX   X  |
|     X X       X X     XXXX XX  X XXXXXX XXX  XX  XXX          X X     XX  |
|  X  X         X   X XXXXX    X   XX XX   X   XX XXX       X     X X   XX  |
|     X     X  X  X     XXXX     XX   X   XX    XXXX          XX     X X X  |
|  X XXX     X   X XX X      X         X     X   X X  X     XXX  X    XXX   |
|    XX   XX XXXX  X   XX X    XX           X     XX            X X   X   X |
|  X      X  X  X              X    X    X X     X X X    XX   XX X  XXX  X |
|  X  XX  X       X X  X X         XX X   X  XX X   X             X  X    X |
|  X  X    X X    X         XXX    X XX      XXXXX X X X    X       XX      |
|  X        XX    X   X           X           XX        X  X    X     X     |
|  X X   X XXX   X X  X           X  X X XX    X       XX     X X  X X      |
|  X X X    XX  X   XX        XX     X        X X    XXXX    XXXX    X      |
|  X XX     X       X X X XX    X             XX   X  X        X            |
|  X    X  X X   X        X   XX   X  X X            X  XXX         X X     |
|  X X   X  XX    X   X    X   X  XX  X XX   XXX      X        XX   XX X    |
|  X         X     X XX  XX          XX X XXX  X     X  X           X XX    |
|     X  X   X X  X X  X  XX  X      XX            XXX  XX            XXX   |
|  X  X  X X XXX       X X X    X  XX    X     X XXX X   X     X     XXX  X |
|  X         XX   XX        XXXX  X     X                  X   X      XX XX |
|  X X     X X     XX X    XXX X        X      X               X X    XXX   |
|  X X     X  X    X   X      X   X    XXX  XX     X       X      X  XXX    |
|  X X     XX        X X X    X X            X                       XXXX   |
|  X X       X   X     X                X     X  X   XXX          XX   X    |
|  X      X  XX X         X  X X           X X  X        X            XX  X |
|  XX      XXXX       X            X  X   XX X  X   X X   X        XX X X   |
|   X XX     XX X     XX  X    XX               X        XX    X  X   XXX   |
|    X  X   XX X      X X X   X X      X XX  X  X         X             X   |
|   XXXX XXXX    X X    X  XX XXX      X        X X XX  X      X    X     X |
|  X      XX    X      X       XXXXX XX X  X  X               X X X     XX  |
|          X XX  X             X    X   X        XX X     X XX              |
|                     X          X           X   X       XXX   X X          |
|  XXXX   XX         X  X  X  XX XXXX X   X   XX X XXX  XXX    XXX   XXXXXX |
|   X XXXXXX  XX  XX XX X  X X X X X X  XX     XX   XX    X      X XXXX  XX |
|       XXXXXXX   X    X XX        X   XX XX X       X  XXX    XXXX      X  |
|  XX    X   XXXX X  X XXX X XX X        X    XXX   X X    XXX X      X XX  |
|  XX XX   XX   X XX X X XX  X X   X      X X  X      X XX XX  X X      X   |
|   X XX       XX         XX             X XXX  XXX  X   X   XX             |
|   X X   X X  X  X     XX XX X XXX X    X  XX X    XX  X  XX  X      X  X  |
|   XXX      X  X X  X  X XXXX      X X X   X  X  X       X   X             |
|   X XX      XX  X     X X X   X  XX XXX XXXX        X X X   X     XX  X X |
|     XX X  X    XXX    XXXX          XXXXXX X X XXX X XX    X     XXX   X  |
|     X X       X X     XXXX XX  X XXXXXX XXX  XX  XXX          X X     XX  |
|  X  X         X   X XXXXX    X   XX XX   X   XX XXX       X     X X   XX  |
|     X     X  X  X     XXXX     XX   X   XX    XXXX          XX     X X X  |
|  X XXX     X   X XX X      X         X     X   X X  X     XXX       XXX   |
|    XX   XX XXXX  X   XX X    XX           X     XX            X X   X   X |
|  X      X  X  X              X    X    X X     X X X    XX   XX X  XXX  X |
|  X  XX  X       X X  X X         XX X   X   X X   X             X  X    X |
|  X  X    X X    X         XXX    X XX      XXXXX X X X    X       XX X    |
|  X        XX    X   X           X           XX        X  X    X     X     |
|  X X   X XXX   X X  X           X  X X XX    X       XX     X X  X XX     |
|  X X X    XX  X   XX        XX     X        X X    XXXX    XXXX  X X      |
|  X XX     X       X X X XX    X             XX   X  X        X            |
|  X    X  X X   X        X   XX   X  X X            X  XXX  X      X X     |
|  X X   X  XX    X   X    X   X  XX  X XX   XXX      X        XX   XX X    |
|  X         X     X XX  XX          XX X XXX  X     X  X           X XX    |
|     X  X   X X  X X  X  XX  X      XX            XXX  XX          X XXX   |
|  X  X  X X XXX       X X      X  XX    X     X XXX     X     X     XXXX X |
|  X         XX   XX        XXXX  X     X                  X   X      XX XX |
|  X X     X X     XX X    XXX X        X  X   X         X     X X    XXX   |
|  X X     X  X    X   X      X   X    XXX   X     X       X      X  XXX    |
|  X X     XX        X X X    X X   XX       X                       XXX    |
|  X X       X   X     X            XX XX        X   XXX          XX   X    |
|  X      X  XX X         X  X X    XX     X X  X        X            XX    |
|  XX      XXXX       X            X  X      X  X   X               X X     |
|   X XX     XX X     XX  X    XX               X        XX    X  X   XXX   |
|    X  X   XX X      X   X   X X     GX XX  X  X         X             X   |
|   XXXX XXXX    X X       XX XXX      X        X X X   X      X            |
|  X      XX           X       XX XX X  X  X  X               X   X     XX  |
+---------------------------------------------------------------------------+